souterrain -- underground
leurs -- yours
autres -- others
sans -- without
sur -- on
bas -- bottom
haut -- top
même -- sogar
qui -- who?
que -- what?
quand -- when?
où -- where?
pourquoi -- why?
tout de suite -- immediately!
voir -- to see
payer -- to pay
donner -- to give
nettoyer -- to clean
ranger -- store
pouvoir -- can, to be able to
savoir -- to know
devoir -- to have to,must
suivre -- to follow
voler -- fliegen
Assey-vous -- please sit down
au -- in
toujours -- always
ici -- here
Ce a l'air -- this seems
plus -- more
le hiver -- winter
le èté -- sommer
le printemps -- frühling
le automne -- herbst
la neige -- der schnee
malade -- krank
